0 0 0 1 2
0 0 0 3 4
4 5 1 2 2
3 4 5 6 7
1 2 3 4 5